Basic Calculator II	Solution in python	2 years ago
Best Time to Buy and Sell Stock with Cooldown	O(n) solution with constant mem	17 months ago
Best Time to Buy and Sell Stock	all versions of buy and sell stock	17 months ago
Burst Balloons	exhastive	16 months ago
Container Most Water	revise	16 months ago
Decode Ways	revise	16 months ago
Find the Duplicate Number	revise	16 months ago
First Missing Positive	revise	16 months ago
Largest Number	custom comparator	17 months ago
Longest Consecutive Sequence	revise	16 months ago
Maximum Product Subarray	revision-solved	16 months ago
Median of Two Sorted Arrays	working solution	17 months ago
Minimum Window Substring	trying with deque	16 months ago
Perfect Squares	revise	16 months ago
Product of Array Except Self	fix comment	2 years ago
Sliding Window Maximum	working in n	16 months ago
Spiral Matrix	revise	16 months ago
Wiggle Sort II	single testcase	17 months ago
Word Break II	Working solution recursion dfs	16 months ago
Word Break	working solution in 50 mins	16 months ago